0
xxxxxxxxxxxxxxxxxxxxxxx
x                      
x xxxxxxxxxxxxxxxxxxx x
x xxxxxxxxxxxxxxxxxxx x
x xxxxxxxxxxxxxxxxxxx x
x xxx     xxx     xxx x
x xxx xxx xxx xxx xxx x
x xxx xxx xxx xxx xxx x
x xxx xxx xxx xxx xxx x
x xxx xxx xxx xxx xxx x
x xxx xxx xxx xxx xxx x
x xxx xxx xxx xxx xxx x
x xxx xxx xxx xxx xxx x
x  S  xxx     xxx     x
xxxxxxxxxxxxxxxxxxxxxxx